0,   0,   0,   0,   0,   0,   0,    0,   0
0,  10,   0,   0,   0,   0,   0, 11.5,   0
0,   8,   0,   0,   0,   0,   0,   10,   0
0,   6,   0,   0,   0,   0,   0,  8.5,   0
0,   4,   3,   2,   1,   3,   5,    7,   0
0,   5,   0,   0,   0,   0,   0,    9,   0
0,   6,   0,   0,   0,   0,   0,   11,   0
0,   7,   0,   0,   0,   0,   0,   13,   0
0,   0,   0,   0,   0,   0,   0,    0,   0
